#################################################################################
#.......#...#...#...........#.....#...#.#.....#m......#.......#.....#........u..#
#####.#.#.#.#.#.###.#######.###.#.#.#.#.#.###.###.#####.#.###.###.#.###########.#
#.....#...#...#.....#.#.....#...#...#...#.#....e#.......#...#.....#.....#.......#
#.###################.#.#####.#########.#.#####.###########.###########.#.#######
#.#...#...#...........#.#.....#.......#.#.....#.....#.....#...#.......#.#.#.....#
#.#S#.###.#.#####.#####.#.###.#.###.###.#####.#####.#.###.###.#.#.#####.#.#.###.#
#.#.#...#.#...#.#.......#.#.#.#.#...#...#.D.#.#...#...#.#.#...#.#.#.....#j..#...#
#.#.###.#.###.#.#########.#.#.###.###.###.#.#.#.#.#####.#.#.###.###.#########.###
#.#...#.#...#...#.#.........#...#.#...#.#.#...#.#.....#...#...#...#.#.#.....#...#
#.###.#.###.###.#.#.#########.#.#.#.###.#.#####.#####.#.#####.###.#.#.#.#.#.###.#
#...#.#c..#.....#.......#...#.#.#.#.#...#...#.....#.#.#.#.....#...#.#...#.#...#.#
#.###.###.#.#############.#.###.#.#.#.#.###.#####.#.#.#.#.#####.###.#.###.###.#.#
#.#...#.#.#.........#.....#...#.#.....#.#.#...#.#...#.#...#...#.....#.#...#...K.#
#.#.###.#.#########.#.#######.#.#########.###.#.###.#.#####.#.#.#######.#########
#.......#.#.......#h..#.....#.#.........#...#.#.....#.......#...#.....#.#...#...#
#.#######.#O#####.#######.#.#.#.#######.###.#.#.#######.#######.#.###F#.#.#.#.#.#
#.#....y..#...#...#.....#.#.#.#.#.#.....#...#.#.#.....#.#.....#...#.#.#...#.#.#.#
###.#####.###.#.###.###.#.###.#.#.#.###.#.#.#.###.###.#.#.###.#####.#.#.###.#.#.#
#...#.....#.#.#...#.#.Z.#...#.#.#.#.#...#.#.#.....#.#.#.#.#.#...#.....#...#...#.#
#.###.#####.#.###A#.#.###.#.#.#.#.#.#####.#########.#.#.#.#.###.#.#########.###.#
#.#.#.#.....#.#.#...#.#...#...#...#.....#.#.........#.#.#.#.#...#.#.......#.#...#
#.#.#.#####.#.#.#######.#########.#####.#.#.#####.#.#.#.#.#.#####.#.###.#.###.#.#
#.#.#...#...#.#...#.....#.....#.......#.#.#.#.#...#.#.#.#.#.....#.#.#...#.....#.#
#.#.###.#.#.#.###.#.#######.#.#####.###.#.#.#.#.#####.#.#.#.#.###.###.#########X#
#.#...#...#.#...#.#...#.....#.....#.#...#.....#.#...#.#.#.#.#...#...#.....#.....#
#.#W#.#####.###N#.###.#.#.#######.###.#.#######.#.#.#.###.#.###.###.#####.###.###
#i#.#.....#.#.#.#...#.#.#.#.....#.....#.#..r..#...#.#...#.#.#.....#.#...#...#.#.#
#.#######.#.#.#.#.###.###.#.###########.#.###.#.###.###.#.###.#####.#.#.###.#.#.#
#.......#...#.#.#...#...#.#.............#.#.#.#.#.#...#...#...#.....#.#.....#.#.#
#.#####.#.###.#.#.#.###.#.#.#############.#.#.#.#.###.#####.###.#####.#######.#.#
#.#.#...#.....#.#.#...#..t#...#.#.......#.#.#.#...#.....#.....#...#...#.....#.#.#
#.#.#.#######.#.#.###.#######.#.#.#.#####.#.#.#.###.###.#####.###.###.#.###.#.#.#
#...#.#...#...#.#...#.....#.#.#...#.....#.#.#.#.#...#.........#.#...#...T.#.#...#
###.#.#.#.#.###.###.#.###.#.#.#########.#.#.#.###.###########.#.###.#####.#.###.#
#...#...#.#.#...#...#...#...#.......#...#.#.#...#.#.....#...#...#...#...#.#...#.#
#.#######.###.###.#####.###########.#.###.#.###.#.#.###.#.#.###.#.###.#.#####.###
#.#...#v#...#.#.#.....#.........#...#...#.#.......#...#..l#...#.#.....#.....#.P.#
#.#.#.#.###.#.#.#####.#########.#.#####.#.###########.#######.#############.###.#
#...#.....#...#...............#.............................#....b..............#
#######################################.@.#######################################
#...#.#.........#.....#...........#...........#...#.....#.......#...#.....Q.#...#
#.#.#.#.#####.###.#.#.#.#####.###.#.###.#.###.#.#.#.###.#.#####.#.#.#.#.###.###.#
#.#.#.#.#...#.....#.#.#.#.#...#...#...#.#.#.....#.#...#...#.....#.#.#.#...#.#...#
#.#.#.#.#.#.#######.###.#.#.#####.###.#.#.#######.###.#####.#####.#.#.###.#.#.#.#
#.#...#.#.#.....#.#.#.B...#.....#.#...#.#.....#.....#.#...#.......#.#.#...#...#.#
#.#####.#.#####.#.#.#.#######.#.###.###.#.###.###.###.#.#####.#####.#.#.#######.#
#.#...#q#..f#.....#...#.....#.#...#.#...#.#.#...#.#.....#...#.#...#...#.#.....#.#
#.#.#.#.#.#.#######.###.###.###.#.#.#.###.#.###.###.#####.#.#.###.#####.#.###.#.#
#...#.#.#.#...#...#p..#.#.#...#.#...#...#.....#...#.#.....#.#.....#...#...#...#.#
#####.#.#####.#.#.###.#.#.###.#########.#####.###.#.#.#####.#####.###.#####.###.#
#.....#.......#.#.#...#.#...#.#.......#.#...#.#.#...#.#...#.....#.....#.#...#.#.#
#.###########.#.#.#####.###.#L#.#####R#.#.#.#.#.#####.#.#.#####.#####.#.#.###.#.#
#...........#.#.#.......#...#...#...#...#.#.#.....#...#.#.....#...#...#.#...#...#
#######.###.#.#.#########.#.#####.#.#######.#####.#.#######.#.###.#.###.###.###.#
#.......#...#.#.#.........#.......#.....#...#.....#.#.....#.#...#.#...#...#...#.#
#.#######.###.#.#.###.#################.#.###.#####.#.#.#.###.###.###.###.###.#.#
#.#.........#.#.#...#.............#.....#.........#.#.#.#.....#...#.#.......#.#.#
#.###.#######.#.###########.#####.#.###############.###.#####.#.###.#.#####.#.###
#...#.#.......#.#.........#.#...#.#.#...#.......#...#...#.#...#.#.....#...#.#...#
#.#G###.#######.#.#######.#.###.#.###.#.#.#####.#.###.###.#.###.#######.#.#####.#
#.#...#....x#.#.#.#z#.....#.....#.....#.#.....#...#...#...#.#...#.......#.#...#.#
#.###.#####.#.#.#.#.#########.#########.#####.#######.#.###.#####.#######.#.#.#.#
#k#.#.....#...#...#.#.....#...#.......#.#...#.#.......#.#...#.....#.#...#...#.#.#
#.#.#####.###.#####.#.###.#.###.#####.#.#.#.#.#.#.#####.#.###.#####.#.#.#####.#H#
#.#.....#...#.....#.#...#.#.#...#...#...#.#...#.#.#.....#.#...#...#...#...#.#.#.#
#.#.###.###.#####.#.###.#.#.#.###.#.###.#.#######.#.###.#.#.###.#.#.###.#Y#.#.#.#
#...#...#.#...#...#.....#..o#.#.#.#.....#.#.......#.#...#...#...#...#...#...#..g#
#####.###.#.###.#######.#####.#.#.#######.#####.###.###.#############.#####.###.#
#...#.#...#.....#.....#.....#.#.#...#...#.......#.....#...#...........#.#...#...#
#.#.#.###.#######.###.#######.#.###.#.###########.###.###.#.###########.#.###.###
#.#.#.#.....#.#.....#.#.......#...#.#...#...#...#...#.#...#.......#...#.I.#.#...#
#.#.#.#.###.#.#.###.#.#.#######.#.#.###.#.###.#.#.###.#.#########.###.#.###.###.#
#.#.#.#.#...#s....#.#.#.......#a#.#.....#.#...#.#.#...#.....#.....#...#.....#.#.#
#.###M#U###.#####.#.#.###.###.###.#####.#.#.###.#.#.#.#####.#.#####.#V#####.#.#.#
#.....#...#...#...#.#...#...#.#...#....n#.#...#d..#.#.#.J.#...#.....#...#..w#.#.#
#.#######.###.#####.###.#####.#.###.#####.###.#####.#.#.#.###.#####.#####.###.#.#
#.......#.#.#...#...#.#.....#.#...#.#...#...#.#.#...#.#.#.#...#...#...........#.#
#######.#.#.###E#.###.#####.#.#.#.#.###.#.###.#.#.#####.#.#####.#.#############.#
#.........#.......#.........C.#.#.......#.......#.......#.......#...............#
#################################################################################.